NO ./assets/mossy_128.png
SO ./assets/wood_128.png
WE ./assets/bluestone_128.png
EA ./assets/eagle_128.png
FL ./assets/wood_128.png
CL ./assets/greystone_128.png
W1 ./assets/bluestone_128.png
W2 ./assets/greystone_128.png
W3 ./assets/wood_128.png
W4 ./assets/prison2_128.png
W5 ./assets/greystone_special1_128.png
W6 ./assets/greystone_special2_128.png
W7 ./assets/greystone_special3_128.png
W8 ./assets/wood_special1_128.png
W9 ./assets/wood_special2_128.png
WA ./assets/end_room_128.png
H1 ./assets/wood_special1_128.png
H2 ./assets/greystone_128.png
H3 ./assets/greystone_special1_128.png
H4 ./assets/greystone_128.png
D1 ./assets/door_128.png
D2 ./assets/door_2_128.png
F1 ./assets/elevator_down_128.png
S0 ./assets/barrel_final.png
S2 ./assets/lamp_final.png
S4 ./assets/bones_final.png
S5 ./assets/guard_final.png
S7 ./assets/dog_final.png
S8 ./assets/table_final.png
S9 ./assets/well_full_final.png
SA ./assets/well_empty_final.png
SB ./assets/chandelier_final.png
SC ./assets/plant_final.png
SD ./assets/table_chairs_final.png
SF ./assets/statue_final.png
SG ./assets/lamp_standing_final.png
SH ./assets/tree_final.png
SI ./assets/barrel_green_final.png
SJ ./assets/pot_final.png
SK ./assets/flag_final.png
SL ./assets/bones_2_final.png
SM ./assets/dead_guard_final.png
SN ./assets/puddle_final.png
I0 ./assets/stimulant.png
I1 ./assets/medkit.png
I2 ./assets/soul.png
I3 ./assets/dogmeal.png
I4 ./assets/gun.png
I5 ./assets/ammo.png
I6 ./assets/treasure0.png
I7 ./assets/treasure1.png
I8 ./assets/treasure2.png

HU ./assets/hud/hud_transparent.png
HN ./assets/hud/numbers.png
FH ./assets/hud/hud_faces.png
DF ./assets/doorframe_128.png

TD ./assets/enemies/dog/dogspritesheet.png
TG ./assets/enemies/guard/guardspritesheet.png

P0 ./assets/weapons/pistol0.png
P1 ./assets/weapons/pistol1.png
P2 ./assets/weapons/pistol2.png
P3 ./assets/weapons/pistol3.png

K0 ./assets/weapons/knife0.png
K1 ./assets/weapons/knife1.png
K2 ./assets/weapons/knife2.png
K3 ./assets/weapons/knife3.png

M0 ./assets/weapons/machinegun0.png
M1 ./assets/weapons/machinegun1.png
M2 ./assets/weapons/machinegun2.png
M3 ./assets/weapons/machinegun3.png

F2 ./assets/elevator_up_128.png

ES ./assets/hud/score_screen.png
EN ./assets/hud/score_numbers.png
EG ./assets/hud/game_over.png

F 84,84,84
C 42,42,42

1111111111111111111111111111111111111111111111111111111111111111111111111
1000000000000000000000000000000000G00000000000000000000000000000000000001
1000000000000000000000000000000000G00000000000000000000000000000000000001
1000000000000000000000000000000000G00000000000000000000000000000000000001
1000000000000000000000000000000000G00000000000000000000000000000000000001
1000000000000000000000000000000000G00000000000000000000000000000000000001
1000000000000000000000000000000000G00000000000000000000000000000000000001
1000000000000000000000000000000000G00000000000000000000000000000000000001
1000000000000000000000000000000000G00000000000000000000000000000000000001
1000000000000000000000000000000000G00000000000000000000000000000000000001
1000000000000000000000000000000000G00000000000000000000000000000000000001
1000000000000000000000000000000000G00000000000000000000000000000000000001
1000000000000000000000000000000000S00000000000000000000000000000000000001
1000000000000000000000000000000000G00000000000000000000000000000000000001
1000000000000000000000000000000000G00000000000000000000000000000000000001
1000000000000000000000000000000000G00000000000000000000000000000000000001
1000000000000000000000000000000000G00000000000000000000000000000000000001
1000000000000000000000000000000000G00000000000000000000000000000000000001
1000000000000000000000000000000000G00000000000000000000000000000000000001
1000000000000000000000000000000000G00000000000000000000000000000000000001
1000000000000000000000000000000000G00000000000000000000000000000000000001
1000000000000000000000000000000000G00000000000000000000000000000000000001
1000000000000000000000000000000000G00000000000000000000000000000000000001
1000000000000000000000000000000000G00000000000000000000000000000000000001
1000000000000000000000000000000000G00000000000000000000000000000000000001
1000000000000000000000000000000000G00000000000000000000000000000000000001
1000000000000000000000000000000000G00000000000000000000000000000000000001
1000000000000000000000000000000000G00000000000000000000000000000000000001
1000000000000000000000000000000000G00000000000000000000000000000000000001
1111111111111111111111111111111111111111111111111111111111111111111111111
