NO assets/bluestone.png
SO assets/redbrick.png
WE assets/purplestone.png
EA assets/square.png
F 128,128,128
C 0,255,255
1111111111111111111111111111111111111
1000000000110000000000000000011111111
10110000011101111110000010001
10010000000000000000000010001
11110000000000000000000000111
10000000000000000000011110011
1111000000000E000000100010001
11110100000000000000010010001
1100000011111101110000001000011111
100000001    111110001100000010001
1000000001111000110101001000111111
11000000110101011111011110001
11110111111101011111011110001
11111111111111111111111111111