NO ./assets/mossy.png
SO ./assets/wood.png
WE ./assets/bluestone.png
EA ./assets/eagle.png
FL ./assets/colorstone.png
CL ./assets/greystone.png
W1 ./assets/bluestone.png
W2 ./assets/greystone.png
W3 ./assets/wood.png
W4 ./assets/prison2.png
S0 ./assets/barrel.png
S1 ./assets/pillar.png
S2 ./assets/lamp5.png
S3 ./assets/door.png
S4 ./assets/bones.png
S5 ./assets/guard_proper.png
S6 ./assets/eagle.png
S7 ./assets/dog_scaled.png

F 130,125,130
C 90,200,220

                            3333333333333
     222222                 3000000000003
     200002      2222222222230000G00000033333
     2000022     2000000000030000000000030003
     2000002     20L0000L000D0000000000GD0G03
     2000002     2000000000030000000000030003
     22222h22222 2000222222230000000000033333
     20000000002 20002      3000000000003
     20L00000LG222000222    333333D333333
     200G0000002000G0002        30003
     2000000G00D000L0002        30G03
     2000000000200000G02        30L03
2222220LG0000L0222222222        30003
200B2200000000G2                30003
2000222222D22222           333333000333
20002   20002              3000G00L0003
22D22   20L02              300333000333
2000222220002              3003330003
20L0200020002              3003330003
200000LG20L02              3333330L03
2000200020G02                   30003
2000222222D22222               233D332               1111111111
20L022G000000002          22222200000222222          100000BBB1
2000220000000002          200G0000000000002          10000000B1
20002200L000L002          200000000000000021111111111100000G001
2000020000000002          2000000000000000010000000001000000001
20000D0G00000002          200000000000G0000D000000000D000000001
2000020000000002          2000000000000000010c00000001000000001
20002200L000L002          2000000000000000211100001111c000000G1
2000220000000002          20000000000000002  110011  1000000001
2000220000000G02          22222200000222222   1001   1000000001
20L0222222D22222               2110111        1001   1110110111
20002   20002                   10001         1001     111111
2000222220002                   10L01         1001
20002G0020002                   10001         10G1 111111111
200000L020L02                   10001         100111010101011
2000200020002                   10001         1000100000c0001
20L0222220002                   10G01         1000D00000000c1
20G0222220G02222222222222       10L01         10G010c00000001
20000000000000000200000G222     10001         111111010101011
200000L000000L000D000G00222     10001             111111111
20000000000000000200000G222     10L01
222222222222222222h222222       10001
        22200200h002       1111111D1111111
        222002002022       100001000100001
        22200000222        10b00D0L0D0b001
          22h2222          100001000100001
           2002            100001000100001
           2w02            111111000111111
           2222            100001000100001
                           10E0bD0L0D000b1
                           100001000100001
                           111111000111111
                           100000000000001
                           100L000L000LG01
                           1G0000000000001
                           141141141141141