NO ./assets/mossy.png
SO ./assets/wood.png
WE ./assets/bluestone.png
EA ./assets/eagle.png
FL ./assets/colorstone.png
CL ./assets/greystone.png
DO ./assets/door.png
S0 ./assets/greenlight.png
S1 ./assets/barrel.png
S2 ./assets/pillar.png
S3 ./assets/bones.png
S4 ./assets/guard.png

F 130,125,130
C 90,200,220

                            1111111111111
     111111                 1000000000001
     100001      1111111111110000G00000011111
     1000011     1000000000010000000000010001
     1000001     10000000000D0000000000GD0G01
     1000001     1000000000010000000000010001
     11111111111 1000111111110000000000011111
     10000000001 10001      1000000000001
     1000000000111000111    111111D111111
     1000000000100000001        10001
     1000000000D00000001        10G01
     1000000000100000001        10L01
111111000000000111111111        10001
1000110000000001                10001
1000111111D11111           111111000111
10001   10001              1000G00L0001
11D11   10001              100111000111
1000111110001              1001110001
1000100010001              1001110001
1000000010001              1111110L01
1000100010001                   10001
1000111111D11111               111D111               1111111111
1000110000000001          11111100000111111          100000BBB1
1000110000000001          100G0000000000001          10000000B1
1000110000000001          100000000000000011111111111100000G001
1000010000000001          1000000000000000010000000001000000001
10000D0000000001          100000000000G0000D000000000D000000001
1000010000000001          1000000000000000010000000001000000001
1000110000000001          10000000000000001111000011110000000G1
1000110000000001          10000000000000001  110011  1000000001
1000110000000001          11111100000111111   1001   1000000001
1000111111D11111               1110111        1001   1110110111
10001   10001                   10001         1001     111111
1000111110001                   10L01         1001
1000100010001                   10001         10G1 111111111
1000000010001                   10001         100111010101011
1000100010001                   10001         100010000000001
1000111110001                   10G01         1000D0000000001
1000111110001111111111111       10L01         10G010000000001
100000000000000001000000111     10001         111111010101011
10000000000000000D000000111     10001             111111111
100000000000000001000000111     10L01
1111111111111111111111111       10001
      111001001001         1111111D1111111
      111001001011         100001000100001
      11100000111          10b00D0L0D00001
        1111111            100001000100001
         1001              100001000100001
         1001              111111000111111
         1111              100001000100001
                           10E00D0L0D00001
                           100001000100001
                           111111000111111
                           100000000000001
                           1000000L000G001
                           1G0000000000001
                           111111111111111